practice makes perfect|Có công mài sắt, có ngày nên kim.
no pain, no gain|Có công mài sắt, có ngày nên kim.
you reap what you sow|Gieo gió, gặt bão.
many hands make light work|Một cây làm chẳng nên non, ba cây chụm lại nên hòn núi cao.
hard work pays off|Lao động chăm chỉ sẽ được đền đáp.
rome wasn’t built in a day|Rồng bay chưa lên trời trong một ngày.
slow and steady wins the race|Chậm mà chắc.
a little effort goes a long way|Có công mài sắt, có ngày nên kim.
don’t put off until tomorrow what you can do today|Việc hôm nay chớ để ngày mai.
well begun is half done|Khởi đầu tốt là thành công một nửa.
better safe than sorry|Cẩn tắc vô ưu.
look before you leap|Nhảy mà không nhìn trước sau.
think before you act|Cẩn thận trước khi làm.
when in Rome, do as the Romans do|Nhập gia tùy tục.
don’t judge a book by its cover|Đừng nhìn mặt mà bắt hình dong.
measure twice, cut once|Đo hai lần, cắt một lần.
easy come, easy go|Có dễ dàng thì cũng mất dễ dàng.
curiosity killed the cat|Tò mò sẽ gặp rắc rối.
a bird in the hand is worth two in the bush|Một con én trong tay hơn trăm con chim trên cành.
don’t bite off more than you can chew|Đừng ôm đồm quá sức.
honesty is the best policy|Thật thà là cha quỷ quái.
actions speak louder than words|Nói được, làm được.
what goes around comes around|Gieo gió, gặt bão.
do unto others as you would have them do unto you.|Làm ơn sẽ gặp ơn.
the truth will come out|Sự thật sẽ được phơi bày.
a friend in need is a friend indeed|Bạn bè khó khăn mới biết ai là bạn thật.
don’t make promises you can’t keep|Đừng hứa những gì mình không làm được.
practice what you preach|Làm theo những gì mình rao giảng.
what is right is not always popular|Điều đúng không phải lúc nào cũng được ưa thích.
better to give than to receive|Cho đi còn quý hơn nhận lại.
health is wealth|Có thực mới vực được đạo.
time is money|Thời gian là vàng bạc.
don’t put all your eggs in one basket|Đừng bỏ trứng vào một giỏ.
the early bird catches the worm|Dậy sớm bắt được cơ hội.
every cloud has a silver lining|Trong cái rủi có cái may.
where there’s a will, there’s a way|Có chí thì nên.
life is short, make it sweet|Cuộc sống ngắn, hãy sống vui.
count your blessings|Hãy biết ơn những gì bạn có.
all that glitters is not gold|Không phải vàng mà cũng sáng.
fortune favors the brave|Người dũng cảm sẽ gặp may.
birds of a feather flock together|Ngưu tầm ngưu, mã tầm mã.
a problem shared is a problem halved|Chia sẻ nỗi buồn, bớt đi một nửa.
two heads are better than one|Hai đầu óc tốt hơn một.
good friends are like stars|Bạn tốt như những vì sao.
don’t judge a man until you’ve walked a mile in his shoes|Đừng đánh giá người khác khi chưa trải qua họ.
actions speak louder than words|Hành động quan trọng hơn lời nói.
it takes two to tango|Một mình không làm được chuyện lớn.
the grass is always greener on the other side|Bên kia đồng xanh hơn.
don’t burn your bridges|Đừng cắt cầu với người khác.
laughter is the best medicine|Tiếng cười là liều thuốc tốt nhất.
A journey of a thousand miles begins with a single step.|Hành trình ngàn dặm bắt đầu từ một bước chân.
Actions speak louder than words.|Hành động quan trọng hơn lời nói.
A leopard cannot change its spots.|Bản tính khó đổi.
A watched pot never boils.|Càng trông chừng thì càng lâu.
Beauty is in the eye of the beholder.|Vẻ đẹp nằm trong con mắt người nhìn.
Beggars can’t be choosers.|Ăn xin thì không được chọn lựa.
Better late than never.|Muộn còn hơn không.
Don’t count your chickens before they hatch.|Đừng đếm gà trước khi nở.
Don’t bite the hand that feeds you.|Đừng phản bội người đã giúp mình.
Don’t cry over spilled milk.|Đừng than khóc chuyện đã qua.
Don’t put the cart before the horse.|Đừng làm việc ngược đời.
Every dog has its day.|Ai rồi cũng có lúc thành công.
Every rose has its thorn.|Hoa hồng nào cũng có gai.
Fail to plan, plan to fail.|Không lên kế hoạch là lên kế hoạch thất bại.
Fortune favors the bold.|Vận may đến với người dũng cảm.
God helps those who help themselves.|Trời giúp người tự giúp mình.
Good things come to those who wait.|Điều tốt đẹp đến với ai biết chờ đợi.
Ignorance is bliss.|Không biết thì lại yên ổn.
If it ain’t broke, don’t fix it.|Cái gì chưa hỏng thì đừng sửa.
If you can’t beat them, join them.|Không thắng được thì nhập bọn với họ.
it takes two to tango|Chuyện gì cũng cần hai phía.
knowledge is power|Kiến thức là sức mạnh.
let bygones be bygones|Chuyện gì qua hãy để qua.
lightning never strikes twice in the same place|Sét không đánh hai lần một chỗ.
make hay while the sun shines|Tranh thủ khi còn cơ hội.
money doesn’t grow on trees|Tiền không mọc trên cây.
necessity is the mother of invention|Cái khó ló cái khôn.
no man is an island|Không ai sống tách biệt hoàn toàn được.
old habits die hard|Thói quen cũ khó bỏ.
one good turn deserves another|Có ơn nên trả ơn.
opportunity knocks but once|Cơ hội chỉ đến một lần.
out of sight, out of mind|Xa mặt cách lòng.
practice makes perfect|Có công mài sắt, có ngày nên kim.
rome wasn’t built in a day|Thành công không thể đạt được trong ngày một ngày hai.
silence is golden|Im lặng là vàng.
the pen is mightier than the sword|Ngòi bút mạnh hơn gươm giáo.
the squeaky wheel gets the grease|Kẻ kêu ca thường được chú ý.
there’s no place like home|Không đâu bằng nhà.
there’s no smoke without fire|Không có lửa làm sao có khói.
to err is human, to forgive divine|Phạm lỗi là con người, tha thứ là đức hạnh.
too many cooks spoil the broth|Lắm thầy thối ma.
two wrongs don’t make a right|Sai không thể sửa sai bằng sai.
variety is the spice of life|Đa dạng làm cuộc sống thú vị.
when the cat’s away, the mice will play|Vắng chủ nhà gà mọc đuôi tôm.
where there’s smoke, there’s fire|Không có lửa làm sao có khói.
you can’t have your cake and eat it too|Không thể có cả hai điều trái ngược.
you can’t judge a tree by its bark|Đừng đánh giá bề ngoài.
you can’t make an omelet without breaking eggs|Không có hy sinh thì không có thành công.
you reap what you sow|Gieo nhân nào gặt quả nấy.
you’re never too old to learn|Học không bao giờ là muộn.






